{
  "maps": {
    "main": {
      "width": 960,
      "height": 480,
      "data": [
        [  0,  1,  2,  3,  3,  3,  3,  3,  3,  3,  3,  3,  3,  7,  8,  9, 10,  3,  3,  3,  3,  3,  3,  3,  3,  3,  3,  2,  1,  0],
        [  0,  1, 16, 16, 16, 16, 16, 16, 16, 16, 16, 16, 16, 21, 22, 23, 24, 16, 16, 16, 16, 16, 16, 16, 16, 16, 16, 16,  1,  0],
        [  0,  1, 30, 30, 30, 30, 30, 30, 30, 30, 30, 30, 30, 35, 36, 37, 38, 30, 30, 30, 30, 30, 30, 30, 30, 30, 30, 30,  1,  0],
        [  0,  1, 44, 44, 46, 15, 15, 15, 15, 29, 29, 29, 29, 49, 50, 51, 52, 29, 29, 29, 29, 15, 15, 15, 44, 44, 44, 44,  1,  0],
        [  0,  1, 44, 44, 44, 44, 14, 15,  1,  1,  5,  6, 15, 29,  4,  4, 29, 15, 15, 15, 14, 15, 15, 15, 44, 44, 44, 44,  1,  0],
        [  0,  1,  1,  1,  1,  1,  1,  1,  1,  1,  1,  1,  1,  1, 32, 33,  1,  1,  1,  1,  1,  1,  1,  1,  1,  1,  1,  1,  1,  0],
        [  0, 29, 43, 29, 29, 29, 29, 29, 29, 29, 29, 29, 29, 29, 29, 29, 28, 15, 15, 15, 15, 15, 15, 15, 15,  1, 11, 12, 13,  0],
        [  0, 17, 29, 29, 29, 29, 29, 17, 29, 29,  4,  4,  4,  4,  4,  4, 15, 15, 15, 14, 15, 15, 15, 44, 15,  1, 25, 26, 27,  0],
        [  0, 29, 56, 57, 58, 59, 60, 61, 62, 63,  4, 29,  1,  1, 32, 33,  1,  1, 15, 64, 65, 66, 67, 15, 15,  1, 39, 40, 41,  0],
        [  0, 29, 70, 71, 72, 73, 74, 75, 76, 77,  4, 43,  1, 45, 45, 45, 45,  1, 15, 78, 79, 80, 81, 15, 15,  1, 53, 54, 55,  0],
        [  0, 29, 84, 85, 86, 87, 88, 89, 90, 91,  4,  4, 34, 45, 18, 19, 45, 34,  4, 92, 93, 94, 95, 15, 15,  1, 45,  4, 45,  0],
        [  0, 29, 98, 99,100,101,102,103,104,105,  4, 43,  1, 45, 45, 45, 45,  1,  4,106,107,108,109, 15, 15,  1, 45,  4, 45,  0],
        [  0, 29, 17, 29,  4,  4,  4,  4,  4,  4,  4, 29,  1,  1, 32, 33,  1,  1,  4,120,121,122,123, 14,  4, 34,  4, 42, 20,  0],
        [  0, 31, 29, 29, 29, 17, 29, 43, 29, 29, 29, 17, 29, 29,  4,  4,  4,  4,  4,  4,  4,  4,  4,  4,  4,  1, 42, 42, 42,  0],
        [  0,  0,  0,  0,  0,  0,  0,  0,  0,  0,  0,  0,  0,  0,  0,  0,  0,  0,  0,  0,  0,  0,  0,  0,  0,  1,  0,  0,  0,  0]
      ],
      "collisions": [
        [  1,  1,  1,  1,  1,  1,  1,  1,  1,  1,  1,  1,  1,  1,  1,  1,  1,  1,  1,  1,  1,  1,  1,  1,  1,  1,  1,  1,  1,  1],
        [  1,  1,  1,  1,  1,  1,  1,  1,  1,  1,  1,  1,  1,  1,  1,  1,  1,  1,  1,  1,  1,  1,  1,  1,  1,  1,  1,  1,  1,  1],
        [  1,  1,  1,  1,  1,  1,  1,  1,  1,  1,  1,  1,  1,  1,  1,  1,  1,  1,  1,  1,  1,  1,  1,  1,  1,  1,  1,  1,  1,  1],
        [  1,  1,  1,  1,  0,  0,  0,  0,  0,  0,  0,  0,  0,  1,  0,  0,  1,  0,  0,  0,  0,  0,  0,  0,  1,  1,  1,  1,  1,  1],
        [  1,  1,  1,  1,  1,  1,  0,  0,  1,  1,  0,  0,  0,  0,  0,  0,  0,  0,  0,  0,  0,  0,  0,  0,  1,  1,  1,  1,  1,  1],
        [  1,  1,  1,  1,  1,  1,  1,  1,  1,  1,  1,  1,  1,  1,  0,  0,  1,  1,  1,  1,  1,  1,  1,  1,  1,  1,  1,  1,  1,  1],
        [  1,  0,  1,  0,  0,  0,  0,  0,  0,  0,  0,  0,  0,  0,  0,  0,  1,  0,  0,  0,  0,  0,  0,  0,  0,  1,  1,  1,  1,  1],
        [  1,  0,  0,  0,  0,  0,  0,  0,  0,  0,  0,  0,  0,  0,  0,  0,  0,  0,  0,  0,  0,  0,  0,  1,  0,  1,  1,  1,  1,  1],
        [  1,  0,  1,  1,  1,  1,  1,  1,  1,  1,  0,  0,  1,  1,  0,  0,  1,  1,  0,  1,  1,  1,  1,  0,  0,  1,  1,  1,  1,  1],
        [  1,  0,  1,  1,  1,  1,  1,  1,  1,  1,  0,  1,  1,  0,  0,  0,  0,  1,  0,  1,  1,  1,  1,  0,  0,  1,  1,  1,  1,  1],
        [  1,  0,  1,  1,  1,  1,  1,  1,  1,  1,  0,  0,  0,  0,  1,  1,  0,  0,  0,  1,  1,  1,  1,  0,  0,  1,  0,  0,  0,  1],
        [  1,  0,  1,  1,  0,  1,  1,  0,  1,  1,  0,  1,  1,  0,  0,  0,  0,  1,  0,  1,  1,  1,  1,  0,  0,  1,  0,  0,  0,  1],
        [  1,  0,  0,  0,  0,  0,  0,  0,  0,  0,  0,  0,  1,  1,  0,  0,  1,  1,  0,  1,  0,  0,  1,  0,  0,  0,  0,  1,  0,  1],
        [  1,  1,  0,  0,  0,  0,  0,  1,  0,  0,  0,  0,  0,  0,  0,  0,  0,  0,  0,  0,  0,  0,  0,  0,  0,  1,  1,  1,  1,  1],
        [  1,  1,  1,  1,  1,  1,  1,  1,  1,  1,  1,  1,  1,  1,  1,  1,  1,  1,  1,  1,  1,  1,  1,  1,  1,  1,  1,  1,  1,  1]
      ],
      "door": [
        { "s":"room01", "x":4,  "y":3,  "tx":13, "ty":7 },
        { "s":"room02", "x":14, "y":3,  "tx":7,  "ty":13 },
        { "s":"room02", "x":15, "y":3,  "tx":7,  "ty":13 },
        { "s":"room03", "x":4,  "y":11, "tx":7,  "ty":13 },
        { "s":"room04", "x":7,  "y":11, "tx":7,  "ty":13 },
        { "s":"room05", "x":20, "y":12, "tx":7,  "ty":13 },
        { "s":"room05", "x":21, "y":12, "tx":7,  "ty":13 },
        { "s":"room06", "x":28, "y":12, "tx":7,  "ty":1 }
      ]
    },
    "room01": {
      "width": 960,
      "height": 480,
      "data": [
        [126,130,130,130,130,130,130,130,130,130,130,130,130,130,127],
        [131,140,144,144,144,144,144,144,144,144,144,144,144,141,132],
        [131,145,198,199,197,198,199,196,197,196,197,196,197,147,132],
        [131,145,197,196,197,196,197,196,197,196,197,196,197,147,132],
        [131,145,197,196,197,196,197,196,197,196,197,196,197,147,132],
        [131,145,197,196,197,196,197,196,197,196,197,196,197,147,132],
        [131,145,197,196,197,196,197,196,197,196,197,196,197,160,161],
        [131,145,197,196,197,196,197,196,197,196,197,196,197,174,175],
        [131,145,197,196,197,196,197,196,197,196,197,196,197,188,189],
        [131,145,197,196,197,196,197,196,197,196,197,196,197,147,132],
        [131,145,157,196,197,196,197,196,197,196,197,196,197,147,132],
        [131,145,157,157,157,196,197,196,197,196,197,196,197,147,132],
        [131,145,157,157,157,157,197,196,197,196,197,196,197,147,132],
        [131,142,146,146,146,146,146,146,146,146,146,146,146,143,132],
        [128,133,133,133,133,133,133,133,133,133,133,133,133,133,129]
      ],
      "collisions": [
        [  1,  1,  1,  1,  1,  1,  1,  1,  1,  1,  1,  1,  1,  1,  1], 
        [  1,  1,  1,  1,  1,  1,  1,  1,  1,  1,  1,  1,  1,  1,  1],
        [  1,  1,  1,  1,  0,  1,  1,  0,  0,  0,  0,  0,  0,  1,  1],
        [  1,  1,  0,  0,  0,  0,  0,  0,  0,  0,  0,  0,  0,  1,  1],
        [  1,  1,  0,  0,  0,  0,  0,  0,  0,  0,  0,  0,  0,  1,  1],
        [  1,  1,  0,  0,  0,  0,  0,  0,  0,  0,  0,  0,  0,  1,  1],
        [  1,  1,  0,  0,  0,  0,  0,  0,  0,  0,  0,  0,  0,  1,  1],
        [  1,  1,  0,  0,  0,  0,  0,  0,  0,  0,  0,  0,  0,  0,  0],
        [  1,  1,  0,  0,  0,  0,  0,  0,  0,  0,  0,  0,  0,  1,  1],
        [  1,  1,  0,  0,  0,  0,  0,  0,  0,  0,  0,  0,  0,  1,  1],
        [  1,  1,  1,  0,  0,  0,  0,  0,  0,  0,  0,  0,  0,  1,  1],
        [  1,  1,  1,  1,  1,  0,  0,  0,  0,  0,  0,  0,  0,  1,  1],
        [  1,  1,  1,  1,  1,  1,  0,  0,  0,  0,  0,  0,  0,  1,  1],
        [  1,  1,  1,  1,  1,  1,  1,  1,  1,  1,  1,  1,  1,  1,  1],
        [  1,  1,  1,  1,  1,  1,  1,  1,  1,  1,  1,  1,  1,  1,  1]
      ],
      "door": [
        { "s":"main", "x":14, "y":7, "tx":4,  "ty":3 }
      ]
    }
  }
}
